##################################################
#..............................@.................#
#####.#####..########.####.##..#######.###....#..#
#####.#####..########.####.....#######.###....#.@#
#####.######@########.####.#.....@.....###.......#
#####.######.########.####.#.#.#######......#....#
#####.######.########.####.#.....#####..#........#
#####.######.########.......J.##@#####..##..#....#
#####@######.########.####.##.#...###...##..#....#
#####@@...##.###....@......##.#.######..##..#@#..#
#########...@......#####@.......######...@..@....#
#########.##.####@.#####........@................#
#####........@.##..#####.........#####..######@..#
######.##@##.#.#...#####......##.#####.@######...#
######.......@....@.......@.@.##.##....@#####.@..#
######@............#.@.......@.....@.............#
######.#.....................@.......@#....###.#.#
######.#..#.##.#.#.#.#####..####....P....@.......#
######.#..#.##.#@#@#.######.########.####..@@....#
######.#..#.####.#.#.######@########.####.@###.#.#
######.#..#.####.#.#.######.##.#####.####..##....#
###.....@............######.##.#####.####..##..#.#
######.#..#.####.#............@@..........@......#
##################################################
